1111111111
1000P00101
1000000001
100EC000C1
1010000001
1010000001
1000000001
1000000001
1000000001
1111111111
