111111111111111
1010P1110011C01
100011EC000C011
10010010100C101
100000010001011
1101010001C0C11
10C1101001000C1
100101001100011
100000010001101
111000110011111
110000100000011
101100011011101
100110000001001
100011111001001
111111111111111
