11111
10P11
10001
1C1E1
11111
